3001/300/2001
3002/400/2002
3003/500/2003
3004/475/2004
3005/480/2005
3006/350/2006
3007/600/2007
3008/500/2008
3009/400/2009
3010/300/2010
3011/350/2011
3012/450/2012
